1111111111111
10C1100000001
100C001111001
1P0011C0E0001
1111111111111
